XXXXXXXXXXXXXXXXXXXXXXXXX
X   X    X         X    X
XXX X    X X X X X X    X
X   X    X              X
X X XX XXX X X X X X    X
X X                     X
X XXXXXXXXXXXXXX XXX    X
X                  X    X
XXXXXXXXXX  XX X X X    X
X       X    X X X X    X
X       X    X   X XX  XX
X       X    XXXXX X    X
X       X        X X    X
XXXX XXXX        X X    X
X       X        X X    X
X X   X X               X
X  X X  XXXX XXXXXXXXXX X
X       X       X     X X
X           X   X XXX X X
X       X   X   X X X X X
X  X X  X XXXXX X X X X X
X X   X X   X   X X   X X
X       X   X   X XXXXX X
X       X       X       X
XXXXXXXXXXXXXXXXXXXXXXXXX
